011111111111111111110
013222222212222292310
011112111212111211110
012212122222221212210
012222122112221222210
012222112214211222210
011122222211222221110
000122122222221221000
111122121232121221111
000022221111122220000
111122222222222221111
000121121111141121000
011122122212221221110
012222122212221222710
012212114212211212210
012412222262222214210
012112122212221211210
015222122212221222210
011221121111121122110
011322222272222223110
011111111111111111110