011111111111111111110
012922222212222222310
012112111212111211210
012222224222225222210
012112221111122211210
012222122212221222210
011132111212111221110
000122122222241221000
111122121112121221111
000022221232122220000
111122121211121221111
000122142272221231000
011122121111121221110
012222222212222222210
012112111212111211210
012212222262222217210
011212221111122412110
012222122212221222210
012111111212111111210
013222222222222222210
011111111111111111110