011111111111111111110
012922222212222222310
012121111212111141210
012122221212122221210
012111221212122111210
014222222222222222210
011122211121112221110
000132212222214221000
111122212212212221111
000022222111222220000
111122212212212221111
000122212222212231000
011122211121112221110
012222222262222227510
012111112212211111210
012271222213222122210
014121221111122121210
012122222222222221410
012111121222121111210
013222221222122222210
011111111111111111110